ঈ: ['ঈ']
ী: ['ঈ']
ক: ['ক্']
খ: ['খ্']
গ: ['গ্']
তুমি: ['তুম্', 'ই']
আকাশ: ['আ', 'কাশ্']
কলম: ['ক্', 'লম্']
চলো: ['চলো']
বাংলা: ['বা', 'ং', 'লা']
মানুষ: ['মান্', 'ুষ্']
মা: ['মা']
দোলনা: ['দোল্', 'না']
পরিবার: ['পরি', 'বার্']
বন্ধু: ['বন্', 'ধু']
বিদ্যালয়: ['বিদ্', '্', 'যাল্', 'য়']
বিশ্ববিদ্যালয়: ['বিশ্', '্', 'ববি', 'দ্', 'যাল্', 'য়']
রবীন্দ্রনাথ: ['রবী', 'ন্দ্', 'রনা', 'থ্']
বিধাতার: ['বিধ্', 'াত্', 'ার্']
আনারস: ['আ', 'নার্', 'স্']
চাট: ['চাট্']
গড়: ['গ্', 'ড়']
হাট: ['হাট্']
কাট: ['কাট্']
লব: ['লব্']
ডাক: ['ডাক্']
টান: ['টান্']
নাম: ['নাম্']
বল: ['বল্']
ধন: ['ধন্']
কলম: ['ক্', 'লম্']
সরম: ['স্', 'রম্']
ঘরছ: ['ঘ্', 'রছ্']
বসত: ['ব্', 'সত্']
নগর: ['ন্', 'গর্']
পলন: ['প্', 'লন্']
মরক: ['ম্', 'রক্']
ভরত: ['ভ্', 'রত্']
দরদ: ['দ্', 'রদ্']
জলধ: ['জ্', 'লধ্']


POEM

হাজার: ('হাজার', ['হাজ্', 'ার্'])
বছর: ('বছর', ['ব্', 'ছর্'])
ধরে: ('ধরে', ['ধরে'])
আমি: ('আমি', ['আ', 'মি'])
পথ: ('পথ', ['পথ্'])
হাঁটিতেছি: ('হাঁটিতেছি', ['হা', 'ঁ', 'টিত্', 'েছ্', 'ই'])
পৃথিবীর: ('পৃথিবীর', ['পৃথ্', 'িব্', 'ীর্'])
পথে: ('পথে', ['পথে'])
সিংহল: ('সিংহল', ['সি', 'ংহল্'])
সমুদ্র: ('সমুদ্র', ['সমু', 'দ্র্'])
থেকে: ('থেকে', ['থেক্', 'এ'])
নিশীথের: ('নিশীথের', ['নিশ্', 'ীথ্', 'ের্'])
অন্ধকারে: ('অন্ধকারে', ['অ', 'ন্', 'ধকা', 'রে'])
মালয়: ('মালয়', ['মাল্', 'য়'])
সাগরে: ('সাগরে', ['সাগ্', 'রে'])
অনেক: ('অনেক', ['অ', 'নেক্'])
ঘুরেছি: ('ঘুরেছি', ['ঘুর্', 'েছ্', 'ই'])
আমি;: ('আমি;', ['আ', 'মি', ';'])
বিম্বিসার: ('বিম্বিসার', ['বিম্', '্', 'বিস্', 'ার্'])
অশোকের: ('অশোকের', ['অ', 'শোক্', 'ের্'])
ধূসর: ('ধূসর', ['ধূস্', 'র্'])
জগতে: ('জগতে', ['জ্', 'গতে'])
সেখানে: ('সেখানে', ['সেখ্', 'ান্', 'এ'])
ছিলাম: ('ছিলাম', ['ছিল্', 'াম্'])
আমি;: ('আমি;', ['আ', 'মি', ';'])
আরো: ('আরো', ['আ', 'রো'])
দূর: ('দূর', ['দূর্'])
অন্ধকারে: ('অন্ধকারে', ['অ', 'ন্', 'ধকা', 'রে'])
বিদর্ভ: ('বিদর্ভ', ['বিদ্', 'র্ভ্'])
নগরে;: ('নগরে;', ['ন্', 'গরে', ';'])
আমি: ('আমি', ['আ', 'মি'])
ক্লান্ত: ('ক্লান্ত', ['ক্', 'লান্', '্ত্'])
প্রাণ: ('প্রাণ', ['প্', 'রাণ্'])
এক: ('এক', ['এ', 'ক্'])
চারিদিকে: ('চারিদিকে', ['চার্', 'িদ্', 'িক্', 'এ'])
জীবনের: ('জীবনের', ['জীব্', 'নের্'])
সমুদ্র: ('সমুদ্র', ['সমু', 'দ্র্'])
সফেন: ('সফেন', ['সফে', 'ন্'])
আমারে: ('আমারে', ['আ', 'মার্', 'এ'])
দুদণ্ড: ('দুদণ্ড', ['দুদ্', 'ণ্ড্'])
শান্তি: ('শান্তি', ['শান্', '্', 'তি'])
দিয়েছিলো: ('দিয়েছিলো', ['দিয্', '়', 'েছ্', 'িল্', 'ও'])
নাটোরের: ('নাটোরের', ['নাট্', 'োর্', 'ের্'])
বনলতা: ('বনলতা', ['বন্', 'লতা'])
সেন: ('সেন', ['সেন্'])
চুল: ('চুল', ['চুল্'])
তার: ('তার', ['তার্'])
কবেকার: ('কবেকার', ['কবে', 'কার্'])
অন্ধকার: ('অন্ধকার', ['অ', 'ন্', 'ধকা', 'র্'])
বিদিশার: ('বিদিশার', ['বিদ্', 'িশ্', 'ার্'])
নিশা: ('নিশা', ['নিশ্', 'আ'])
মুখ: ('মুখ', ['মুখ্'])
তার: ('তার', ['তার্'])
শ্রাবস্তীর: ('শ্রাবস্তীর', ['শ্', 'রাব্', 'স্', 'তীর্'])
কারুকার্য;: ('কারুকার্য;', ['কার্', 'ুক্', 'ার্', '্য;'])
অতিদূর: ('অতিদূর', ['অ', 'তিদ্', 'ূর্'])
সমুদ্রের: ('সমুদ্রের', ['সমু', 'দ্', 'রের্'])
'পর: ("'পর", ["'", 'পর্'])
হাল: ('হাল', ['হাল্'])
ভেঙে: ('ভেঙে', ['ভেঙ্', 'এ'])
যে: ('যে', ['যে'])
নাবিক: ('নাবিক', ['নাব্', 'িক্'])
হারায়েছে: ('হারায়েছে', ['হার্', 'ায্', '়', 'েছ্', 'এ'])
দিশা: ('দিশা', ['দিশ্', 'আ'])
সবুজ: ('সবুজ', ['সবু', 'জ্'])
ঘাসের: ('ঘাসের', ['ঘাস্', 'ের্'])
দেশ: ('দেশ', ['দেশ্'])
যখন: ('যখন', ['য্', 'খন্'])
সে: ('সে', ['সে'])
চোখে: ('চোখে', ['চোখ্', 'এ'])
দেখে: ('দেখে', ['দেখ্', 'এ'])
দারুচিনি-দ্বীপের: ('দারুচিনি-দ্বীপের', ['দার্', 'ুচ্', 'িন্', 'ই-দ্', 'বীপ্', 'ের্'])
ভিতর: ('ভিতর', ['ভিত্', 'র্'])
তেমনি: ('তেমনি', ['তেম্', 'নি'])
দেখেছি: ('দেখেছি', ['দেখ্', 'েছ্', 'ই'])
তারে: ('তারে', ['তার্', 'এ'])
অন্ধকারে;: ('অন্ধকারে;', ['অ', 'ন্', 'ধকা', 'রে', ';'])
বলেছে: ('বলেছে', ['বলে', 'ছে'])
সে: ('সে', ['সে'])
'এতোদিন: ("'এতোদিন", ["'", 'এত্', 'োদ্', 'িন্'])
কোথায়: ('কোথায়', ['কোথ্', 'ায্', '়'])
ছিলেন?': ("ছিলেন?'", ['ছিল্', 'েন্', "?'"])
পাখির: ('পাখির', ['পাখ্', 'ির্'])
নীড়ের: ('নীড়ের', ['নীড্', '়', 'ের্'])
মত: ('মত', ['মত্'])
চোখ: ('চোখ', ['চোখ্'])
তুলে: ('তুলে', ['তুল্', 'এ'])
নাটোরের: ('নাটোরের', ['নাট্', 'োর্', 'ের্'])
বনলতা: ('বনলতা', ['বন্', 'লতা'])
সেন: ('সেন', ['সেন্'])
সমস্ত: ('সমস্ত', ['স্', 'মস্ত্'])
দিনের: ('দিনের', ['দিন্', 'ের্'])
শেষে: ('শেষে', ['শেষ্', 'এ'])
শিশিরের: ('শিশিরের', ['শিশ্', 'ির্', 'ের্'])
শব্দের: ('শব্দের', ['শব্', 'দের্'])
মতন: ('মতন', ['ম্', 'তন্'])
সন্ধ্যা: ('সন্ধ্যা', ['সন্ধ্', 'যা'])
আসে;: ('আসে;', ['আ', 'সে', ';'])
ডানার: ('ডানার', ['ডান্', 'ার্'])
রৌদ্রের: ('রৌদ্রের', ['রৌদ্', '্', 'রের্'])
গন্ধ: ('গন্ধ', ['গ্', 'ন্ধ্'])
মুছে: ('মুছে', ['মুছ্', 'এ'])
ফেলে: ('ফেলে', ['ফেল্', 'এ'])
চিল;: ('চিল;', ['চিল্', ';'])
পৃথিবীর: ('পৃথিবীর', ['পৃথ্', 'িব্', 'ীর্'])
সব: ('সব', ['সব্'])
রঙ: ('রঙ', ['রঙ্'])
নিভে: ('নিভে', ['নিভ্', 'এ'])
গেলে: ('গেলে', ['গেল্', 'এ'])
পাণ্ডুলিপি: ('পাণ্ডুলিপি', ['পাণ্', '্', 'ডুল্', 'িপ্', 'ই'])
করে: ('করে', ['করে'])
আয়োজন: ('আয়োজন', ['আ', 'য়', 'োজ্', 'ন্'])
তখন: ('তখন', ['ত্', 'খন্'])
গল্পের: ('গল্পের', ['গল্', 'পের্'])
তরে: ('তরে', ['তরে'])
জোনাকির: ('জোনাকির', ['জোন্', 'াক্', 'ির্'])
রঙে: ('রঙে', ['রঙে'])
ঝিলমিল;: ('ঝিলমিল;', ['ঝিল্', 'মিল্', ';'])
সব: ('সব', ['সব্'])
পাখি: ('পাখি', ['পাখ্', 'ই'])
ঘরে: ('ঘরে', ['ঘরে'])
আসে—সব: ('আসে—সব', ['আ', 'সে', '—সব্'])
নদী—ফুরায়: ('নদী—ফুরায়', ['নদী', '—', 'ফুর্', 'ায্', '়'])
এ-জীবনের: ('এ-জীবনের', ['এ', '-', 'জীব্', 'নের্'])
সব: ('সব', ['সব্'])
লেনদেন;: ('লেনদেন;', ['লেন্', 'দেন্', ';'])
থাকে: ('থাকে', ['থাক্', 'এ'])
শুধু: ('শুধু', ['শুধ্', 'উ'])
অন্ধকার: ('অন্ধকার', ['অ', 'ন্', 'ধকা', 'র্'])
মুখোমুখি: ('মুখোমুখি', ['মুখ্', 'োম্', 'ুখ্', 'ই'])
বসিবার: ('বসিবার', ['বসি', 'বার্'])
বনলতা: ('বনলতা', ['বন্', 'লতা'])
সেন: ('সেন', ['সেন্'])
